81 82 75 27 27 27 27 27 79 74 74 74 74 74 74 80 27 27 27 27 27 21 27 27 21 27 27 27 27 27 21 27 27 27 27 27 21 27 21 27 27 27 27 26 27 27 25 27 27 26 
73 73 77 27 27 27 21 27 76 81 82 81 81 82 81 75 27 21 27 27 27 27 27 27 27 27 27 21 27 27 27 27 27 21 27 27 27 27 21 27 27 21 27 27 26 27 27 27 27 27 
27 27 27 27 27 27 27 27 76 81 81 82 81 81 82 75 27 27 27 27 47 15 15 15 15 15 15 33 15 15 15 15 15 15 15 15 15 33 15 15 15 15 15 15 15 15 15 15 15 33
27 27 21 27 21 27 30 27 76 82 81 81 81 82 81 75 27 27 22 27 49 17 14 132 133 14 17 39 14 14 131 17 14 17 131 14 14 39 14 132 133 14 153 154 14 132 133 14 14 39 
30 27 23 27 27 21 27 27 78 73 83 81 85 73 73 77 27 26 27 27 48 3 3 135 134 3 3 34 138 3 3 3 3 3 3 3 138 34 3 135 134 3 3 3 3 135 134 3 3 34 
27 21 27 27 27 27 27 27 13 13 76 81 75 13 13 13 27 27 27 27 29 1 1 136 137 1 1 32 139 1 1 1 18 1 1 1 139 32 1 136 137 1 1 1 1 136 137 1 1 32 
13 13 27 27 27 27 21 27 13 13 76 82 75 13 27 27 27 27 27 27 29 1 1 1 1 1 1 32 1 1 19 155 156 157 20 1 1 32 1 1 1 1 1 1 1 1 1 1 1 32 
74 74 74 74 74 80 27 27 79 74 84 81 75 13 27 22 27 27 21 27 29 1 18 1 1 1 1 1 1 1 1 158 160 159 1 1 1 1 1 1 1 18 28 28 18 1 1 1 1 32 
81 82 81 82 82 75 27 27 76 82 81 81 75 13 27 27 27 27 27 27 29 1 151 152 20 1 1 1 1 1 19 158 160 159 20 1 1 1 1 1 19 59 60 61 62 20 1 1 1 32 
73 73 73 73 73 77 27 27 78 73 73 73 77 13 27 27 26 27 23 27 29 1 59 60 61 62 1 32 1 1 1 158 160 159 1 1 1 32 1 147 28 66 64 65 63 28 147 1 1 32 
27 27 27 27 27 27 27 22 21 27 27 23 27 27 27 27 27 27 27 27 29 1 66 64 65 63 1 32 1 1 19 161 162 163 20 1 1 32 1 148 19 67 68 69 70 20 148 1 1 32 
21 27 23 23 27 27 27 27 27 27 23 27 27 27 27 27 27 27 27 27 29 1 67 68 69 70 1 32 147 1 1 1 1 1 1 1 147 32 1 1 1 1 1 1 1 1 1 1 1 32 
27 27 27 21 27 27 27 27 27 27 27 27 27 21 27 27 27 27 27 27 29 1 1 1 1 1 1 32 148 1 1 1 1 1 1 1 148 32 1 1 1 1 1 1 1 1 1 1 1 32 
15 15 15 15 15 15 15 7 15 15 15 15 15 15 15 15 15 15 15 15 15 15 15 7 15 15 15 15 15 15 15 15 15 15 15 15 15 15 15 15 15 15 15 7 15 15 15 15 15 33 
14 14 71 14 17 14 16 27 16 14 17 14 14 14 17 14 16 71 16 14 131 14 16 1 16 14 14 153 154 14 14 16 71 16 14 14 14 153 154 14 14 14 16 1 16 14 153 154 14 39 
3 3 72 3 3 3 3 27 3 3 3 3 3 3 3 3 3 72 3 3 3 3 3 1 3 3 3 3 3 3 3 3 72 3 3 3 3 3 3 3 3 138 3 1 3 138 3 3 3 34 
1 1 1 1 1 1 1 1 1 1 1 1 1 1 1 1 1 1 1 1 1 1 1 1 1 1 1 1 1 1 1 1 1 1 1 1 1 1 1 1 1 139 1 1 1 139 1 1 1 32 
1 1 1 1 1 1 1 1 1 1 1 1 1 1 1 1 1 1 1 1 1 1 1 1 1 1 1 1 1 1 1 1 1 1 1 1 1 1 1 1 1 1 1 1 1 1 1 1 1 32 
15 15 7 15 15 41 1 1 1 44 15 15 15 15 15 15 15 15 7 15 15 15 15 15 15 15 15 15 15 15 15 15 7 15 15 15 15 33 125 126 127 15 15 7 15 15 15 15 15 33 
14 14 1 141 142 42 1 1 1 45 14 14 14 153 154 14 14 14 1 14 14 141 142 14 16 71 16 14 141 142 14 14 1 14 14 132 133 39 130 129 128 14 16 1 16 14 132 133 14 39 
3 3 1 144 196 43 1 1 30 46 3 3 3 3 3 3 3 3 1 3 3 144 196 3 3 72 3 3 144 196 3 3 1 3 3 135 134 34 3 3 3 3 3 1 3 3 135 134 138 34 
27 27 27 145 146 29 1 1 1 40 6 6 6 6 6 6 6 6 6 6 6 145 146 6 6 6 6 6 145 146 6 6 6 6 6 136 137 38 35 35 35 35 35 35 35 30 136 137 140 37 
27 21 27 27 27 29 1 1 1 40 6 6 6 6 6 6 6 6 6 6 6 6 6 6 6 6 6 6 6 6 6 6 6 6 6 6 6 38 35 123 35 35 35 35 35 35 35 35 35 37 
27 27 27 27 27 29 1 1 1 40 6 6 186 188 188 164 188 188 187 6 6 6 6 6 6 6 6 6 6 6 6 6 6 6 6 6 6 38 123 119 120 35 35 35 35 30 35 35 35 37 
27 27 27 21 27 29 1 1 1 40 6 6 189 6 168 165 169 6 189 6 6 6 6 6 6 6 6 150 6 190 191 190 191 6 150 6 6 38 35 122 121 124 35 35 35 35 30 35 35 37 
27 27 27 21 27 29 30 1 1 40 6 6 189 6 170 166 171 6 189 6 6 6 6 6 6 6 6 149 193 174 175 176 177 194 149 6 6 38 35 35 124 35 35 35 35 35 35 35 35 37 
27 21 27 27 27 29 1 1 1 40 6 6 189 6 172 167 173 6 189 6 6 6 6 6 6 6 6 6 192 179 151 152 178 195 6 6 6 38 35 35 35 35 35 35 123 119 120 35 35 37 
27 27 27 26 27 29 1 1 1 40 6 6 184 188 188 188 188 188 185 30 6 6 6 6 6 6 6 6 6 180 181 182 183 30 6 6 6 38 35 35 35 35 35 35 35 122 121 124 35 37 
26 27 27 21 27 29 1 1 1 40 6 9 6 6 143 152 6 6 6 6 6 6 6 6 6 6 6 6 6 6 6 6 6 6 6 6 6 38 35 123 132 133 35 35 35 35 35 35 35 37 
27 27 27 27 27 29 1 30 1 40 6 6 6 6 6 6 6 6 6 6 6 199 200 201 198 90 6 6 6 6 6 6 6 9 6 6 6 38 35 35 135 134 35 35 35 35 35 35 35 37 
27 27 27 21 27 29 1 1 1 40 6 6 6 6 6 6 6 6 6 6 96 95 94 93 92 91 6 6 6 6 6 6 6 6 6 6 6 58 15 15 15 15 15 7 15 15 125 126 127 33 
27 27 27 27 27 29 1 1 1 40 6 6 6 6 6 6 6 6 6 6 97 98 99 100 101 102 6 6 6 6 6 6 6 6 6 6 6 50 14 132 133 14 16 35 16 14 130 129 128 39 
21 27 26 27 27 29 1 1 1 40 6 6 6 6 6 6 6 6 6 6 108 107 106 105 104 103 6 6 6 6 6 6 6 6 6 6 6 53 3 135 134 3 138 35 138 3 3 3 3 34 
27 27 27 27 27 29 1 1 1 40 6 6 9 6 6 6 6 6 6 6 197 110 111 112 113 114 6 6 6 6 193 6 6 194 6 6 6 38 35 136 137 35 140 35 140 35 35 35 35 37 
25 27 24 27 27 29 30 1 1 40 6 6 6 6 6 6 6 6 6 6 6 118 117 116 115 6 6 6 6 6 192 151 152 195 6 6 6 38 35 35 35 35 35 35 35 35 30 30 35 37 
27 27 27 27 27 29 1 1 1 40 6 6 150 6 190 191 190 191 6 150 6 6 6 6 6 6 6 6 186 188 188 164 188 188 187 6 6 38 35 35 35 35 35 35 35 30 35 35 35 37 
27 21 27 25 27 29 1 1 1 40 6 6 149 193 174 175 176 177 6 149 6 6 6 6 6 6 6 6 189 6 168 165 169 6 189 6 6 38 123 119 120 35 35 35 35 35 35 35 35 37 
27 27 27 27 27 29 1 1 1 40 6 6 6 192 179 143 152 178 194 6 6 6 6 6 6 6 6 6 189 6 170 166 171 6 189 6 6 38 35 122 121 124 35 35 35 35 124 35 35 37 
27 25 27 27 27 29 1 1 1 40 6 6 6 6 180 181 182 183 195 6 6 6 6 6 6 6 6 6 189 6 172 167 173 6 189 6 6 38 35 35 35 35 35 35 35 119 120 35 35 37 
27 27 27 22 27 29 1 1 1 40 6 6 6 6 6 6 6 6 6 6 6 6 6 6 6 6 6 6 184 188 188 188 188 188 185 6 6 38 35 35 35 35 35 35 123 122 121 124 35 37 
27 22 27 27 27 29 1 1 1 40 6 6 6 132 133 6 9 132 133 6 6 6 6 6 6 6 6 6 6 6 6 6 6 6 6 6 6 38 35 132 133 35 35 35 35 35 35 35 35 37 
27 27 27 27 27 29 1 1 1 40 6 6 6 135 134 6 6 135 134 6 6 6 6 6 6 6 6 6 9 6 6 6 6 6 30 30 6 38 35 135 134 35 35 35 35 35 35 35 35 37 
27 27 27 27 27 29 1 1 1 57 15 15 15 15 15 7 15 15 15 15 15 15 15 15 15 15 15 15 15 15 15 15 7 15 15 15 15 15 15 15 15 15 15 7 15 15 15 15 15 33 
21 27 27 27 27 29 1 1 30 55 14 131 14 14 14 6 14 14 14 131 14 14 16 71 16 14 14 153 154 14 14 14 6 14 14 14 14 153 154 14 14 14 16 35 16 14 14 131 14 39 
27 27 27 27 21 29 1 1 1 54 3 3 3 3 3 6 3 3 3 3 3 3 3 72 3 3 3 3 3 3 3 3 6 3 3 3 3 3 3 3 3 3 3 35 3 3 3 3 3 34 
27 27 27 27 27 29 1 1 1 1 1 1 1 1 1 1 1 1 1 1 1 1 1 1 1 1 1 1 1 1 1 1 1 1 1 1 1 1 1 1 1 1 1 1 1 1 1 1 1 32 
27 27 21 27 27 29 1 1 1 1 1 1 1 1 1 1 1 1 1 1 1 1 1 1 1 1 1 1 1 1 1 1 1 1 1 1 1 1 1 1 1 1 1 1 1 1 1 8 1 32 
27 27 27 27 27 56 15 15 15 15 15 15 15 15 15 15 15 15 15 15 15 15 15 15 15 15 15 15 15 15 15 15 15 15 15 15 15 15 15 15 15 15 15 15 15 15 15 15 15 15 
27 27 27 27 27 51 14 14 17 14 14 14 14 14 17 14 14 14 14 14 17 14 14 14 14 14 17 14 14 14 14 14 17 14 14 71 14 14 17 14 14 14 14 14 17 14 14 14 14 14 
27 27 27 27 27 52 3 3 3 3 3 3 3 3 3 3 3 3 3 3 3 3 3 3 3 3 3 3 3 3 3 3 3 3 3 72 3 3 3 3 3 3 3 3 3 3 3 3 3 3 
